1111111111111111111111111111111111
1E
10
10
1P
1111111111111111111111111111111111