1111111111111111111111111111111111
1C0000000I00000C00000C000000000001
1010010100100000101001000100010101
1E10010010101010001001000100010101
1P0000000C00C0000000000001000000C1
1111111111111111111111111111111111